,202,210,208,402,404,408,N203
202,0,3,1,3,1,1,1
210,3,0,2,1,1,1,1
208,1,2,0,2,1,1,1
402,3,1,2,0,1,1,1
404,1,1,1,1,0,1,1
408,1,1,1,1,1,0,1
N203,1,1,1,1,1,1,0
